
NO ./textures/forest00.png
SO ./textures/forest01.png
WE ./textures/forest02.png
EA ./textures/forest03.png

F 220,100,0








C 225,30,0






                              111
                               1
                              1011
                              10N01
                                1001
                              1111


