
NO ./textures/forest00.png
SO ./textures/forest01.png
EA ./textures/forest03.png

F 220,100,0








WE ./textures/forest02.png
C 225,30,0

  1111              
  10N1
    1
  1111


