

NO ./textures/forest00.png
SO ./textures/forest01.png
EA ./textures/forest03.png
WE ./textures/forest02.png

F 220,100,0
C 225,30,0

1111111
11110N1
1111111
1111111