

NO ./textures/stonewall00.png
SO ./textures/forest01.png
EA ./textures/door.png
WE ./textures/stonewall01.png

C 225,30,0
F 2,1,1

  111
11101
100N1
1111