

NO ./textures/stonewall00.png
SO ./textures/forest01.png
EA ./texures/door.png
WE ./textures/stonewall01.png

C 225,30,0
F 2,,1

  111
11101
1N00001  111
11111
1