WE ./textures/stonewall01.png
EA ./textures/stonewall01.png
C 65,105,225

F 165,42,42

NO ./textures/stonewall00.png
SO ./textures/stonewall00.png


11111111111111111111111111111111
11111100000000000111000000000001
1000000000D0000001 10000000000011111111111111
100N00000000000001110000000000000000000000001
111111000000000000000000000000011111100000001
11111111111111111111111111111111    111111111
