

NO ./textures/forest00.png
SO ./textures/forest01.png
WE ./textures/forest02.png
EA ./textures/forest03.png

F 220,100,0
C 225,30,0

1111111111111111111111111111111111111111
1000000000000000000000000000000010000001
1000000000000000000000000000000010000001
1000000000000000001000000000000010000001
1000000000000000000000000000000010000001
1000000000000000011000000000000011110111
1110000000000000000000000000000000000001
1000000000000000000000100000000000000011
1000000000000000000000000000000000000001
1000000000000000000000000000000000000001
1000000000000000000000100000000000000011
1110000000000000000000000000000000000001
1000000000000000000000000000000000000001
10000000000000000000000000N0000000000001
1000000000011110000000000000000000000001
1000000000000000000000000000000000000001
1000000000000000000000000000000000000001
1000000000000000000000000000000000000001
1000000000000000000000000000000000000001
1000000000000000000000000000000000000001
1111111111111111111111111111111111111111
