

NO ./textures/forest00.png
SO ./textures/forest01.png
WE ./textures/forest02.png
EA ./textures/forest03.png

F 220,100,0
C 225,30,0

000000000000000000000000000000000000000000
011111111111111111111111111111111111111110
010000000000000000000000000000000000000010
010000000000000000000000000000000000000010
010000000000000000010000000000000000000010
010000000000000000000000000000000000000010
010000000000000110000000000000001111000010
011100000000000000000000000000000000000010
010000000000000000000001000000000000000110
010000000000000000000000000000000000000010
010000000000000000000000000000000000000010
01000000000000E000000001000000000000000110
011100000000000000000000000000000000000010
010000000000000000000000000000000000000010
010000000000000000000000000000000000000010
010000000000111100000000000000000000000010
010000000000000000000000000000000000000010
010000000000000000000000000000000000000010
010000000000000000000000000000000000000010
010000000000000000000000000000000000000010
010000000000000000000000000000000000000010
011111111111111111111111111111111111111110
000000000000000000000000000000000000000000