

NO ./textures/forest00.png
SO ./textures/forest01.png
WE ./textures/forest02.png
EA ./textures/forest03.png

F 220,100,0
C 225,30,0

1111111111111111111111111111111111111111
1000000000000000000000000000000000000001
1000000000000000000000000000000000000001
1000000000000000001000000000000000000001
1000000000000000000000000000000000000001
1000000000000000011000000000000000000001
1110000000000000000000000000000000000001
   1000000000000000000100000000000000011
   1000000000000000000000000000000000001
   1000000000000000000000000000000000001
   1000000000000000000100000000000000011
1110000000000000000000000000000000000001
1000000000000000000000000000000000000001
10000000000000000000000000N00000000000001111
10000000000111100000000000000000000000000001
10000000000000000000000000000000000000000001
10000000000000000000000000000000000000001111
1000000000000000000000000000000000000001
1000000000000000000000000000000000000001
1000000000000000000000000000000000000001
1111111111111111111111111111111111111111
