

SO ./textures/forest01.png
WE ./textures/forest02.png
EA ./textures/forest03.png

F 220,100,0
C 225,30,0

NO ./textures/forest00.png
1111111111111111111111111111111111111111
1000000100000000100000000000000000000001
1000000100000000100000000000000000000001
1000000100000000100000000000000000000001
1000000111111D11100000000000000000000001
1000000000000000000000000000000000000001
1000000000000000000000000000000000000001
1000000000000000000000000000000000000001
1000000000000000000000000000000000000001
1000000000000000000000000000000000000001
1000000000000000000000000000000000000001
1000000000000000000000000000000000000001
1000000000000000000000000000000000000001
1000000000000000000000000000000000000001
1000000000000001111D111111E11111111111111
1000000000000001000000000000000000000001
1000000000000001000000000000000000000001
1000000000000001000000000000000000000001
100000000000000100000000000000000000001
1000000000000001000000000000000000000001
1111111111111111111111111111111111111111
