

NO ./textures/stonewall00.png
SO ./textures/stonewall00.png
WE ./textures/stonewall01.png
EA ./textures/stonewall01.png

F 165,42,42
C 65,105,225

1111111
1000001
100N001
1111111
