

NO ./textures/stonewall00.png
SO ./textures/stonewall00.png
WE ./textures/stonewall01.png
EA ./textures/stonewall01.png

F 165,42,42
C 65,105,225

11111111111111111111111111111111111111111111111111111111111111111111111111111111
1000000000000000000000000000000D00000001000000000000000000000000000000D000000001
1000000000000000000000000000000100000001000000000000000000000000000000D000000001
1000000000000000001000000000000100000000000000000000000000000000000000D000000001
1000000000000000000000000000000100000001000000000000000000000000000000D000000001
10000000000000000110000000000001DDD11111000000000000000000000000000000D000000001
1110000000000000000000000000000000000001000000000000000000000000000000D000000001
1000000000000000000000100000000000000011000000000000000000000000000000D000000001
1000000000000000000000000000000000000001000000000000000000000000000000D000000001
10000000000N00000000000000000D0000000001000000000000000000000000000000D000000001
1000000000000000000000100000000000000011000000000000000000000000000000D000000001
1110000000000000000000000000000000000001000000000000000000000000000000D000000001
1000000000000000000000000000000000000001000000000000000000000000000000D000000001
1000000000000000000000000000000000000001000000000000000000000000000000D000000001
1000000000011110000000000000000000000001000000000000000000000000000000D000000001
1000000000000000000000000000000000000001000000000000000000000000000000D000000001
1000000000000000000000000000000000000001000000000000000000000000000000D000000001
1000000000000000000000000000000000000001000000000000000000000000000000D000000001
1000000001111111111111111111111111001111000000000000000000000000000000D000000001
1000000000000000000000000000000000000001000000000000000000000000000000D000000001
11111111111111111111111111111111111111111111111111111111111111111111111111111111
