
NO ./textures/stonewall01.png
SO ./textures/stonewall01.png
WE ./textures/stonewall00.png
EA ./textures/stonewall01.png

F 165,42,42
C 65,105,225

11111111111111111111111111111111
11111100000000000000000000000001
10000000000000000000000000000001
100N0000000001110000000000000001
1111110000000D010000000000000001
11111111111111111111111111111111
